SA.....G.AAA.A.G..
A....AAA.A......GA
.A..A..AAA...A....
.A.AAAG.AAAG...GA.
.A.GAGA....A.A.A.G
.A.....AA.A.A.AG..
A..A.....A....GAA.
A...A.A.A.....A...
G..AG.AAA..A.....A
A..AA..GAA..AA..G.
..A.....AA.AGAA.A.
.G...G......AA..A.
.AA......AA.AG..AA
GGA..G.G..AA......
GA.....G.A...G....
..A..AA.....A.....
.A.A.......A..A..A
.AG..AAA.A.A.A...E
