SAG.....A.
.A..AA...A
A.A.A.AAA.
A.........
...A..AG.A
GA.GA.AAA.
..A..A...A
AA..A...A.
AG....G...
..A....GAE
