S...G.GA..AA
....G...GA..
.AG..A.AA...
.A.....G....
.A........A.
A.A..AA.A...
AAA.A..A.A.A
.A.........G
......A...A.
A..A...AA..A
.......G.A.A
G.A...AA...E
