S.AA...GA.A...A...A
..A..G..A.G..A...G.
....A..G..AA.A...AG
...AAAG.....A......
..A.A..AAA..AA.....
AA....AAA..AA.G...A
.A.A.....A.GG......
.A.GA......A...GA.A
.AA....AAA.AA.A....
...AG......AAA.GAAG
A.A......A.A..AA..A
..A...AA.GG...A....
...G....GA...AAAA..
A.....AA.GAAA.....A
....AA..G.A.AAA...A
AA.A..A....A.......
.....A.....A.......
.A.AGAA..AA...GA...
........A.....G...E
