S...AA..A....
A..A....AA..A
AA...AA....A.
.G...AA..A..A
GA..G.AA..AAA
G..AA.A..A..A
G..AAA.A.G..A
...A......A..
..A.A...A.G.A
.G...AA.GGG..
.A...G.AG.AGA
...A.A.....AG
.A..........E
