SA.A....GAA
A.A..A.AAA.
A..A....A..
.A...AA...A
A.A...A.GG.
..AA.....A.
.AA..AA.A.A
.A......A.A
A......A...
...AA....AA
A...A.A.A.E
