S.A.AG.AAG.AAG..
.A.A.A.GAA.A.G..
.AG........A.AA.
..G..A....AAGAAA
.....A.A.AG.A.A.
A..G..AGAA....AG
A....G.A.A..AA..
.A...GAAG....AAA
...AA.AA..A..G.A
..GA..A...A.G..G
.AA...A....A..A.
.A..AAAA.A.AG.A.
.....A.G......AA
.AA.....A.......
...A....AA..A.AA
A..A...A...AA..E
