S....A.AGA.......
..A...A..G..AAAA.
.AAAAA.AAG....AA.
...AG..A....A....
.AG.A.A..G.AG..AA
...A...GA...AGG.A
...AG...AA....A.A
....A.AA...AA....
.A.A.GA.....G.A..
.........GAA.AAAA
.....AAA....AA.GA
.G.....GA.GA.....
A.A..A..A.GAG.G.A
A....AAA...AA..A.
...A.GG....AAAG..
.......A..A..A...
.A..............E
