SAAA.GG.A..AA.A
...G..AA.A.AAA.
.......A.AG...G
.A..AA..G.G.A.A
G...A....AAG.AA
AA.A.A...A.....
G..AGAA...A.A.A
A....AGGAA.A...
A...AA..G.AA...
A....AA......GG
...AG.A.AG..A..
G....G..G.....G
AA.A...A....A.A
.....A........A
G.A.A..A.....AE
