S.A..A.AA..A..
A..G.A.A...AAA
A..AA...A..A..
.A...G..A.A.A.
.A.........A..
..A.AAA..A..A.
G....A.....A..
.GGA.A.AA.G...
.G.GA.AGG....A
.AAG.....G.G..
.G.A.A.A.....A
..G.....A.....
.A.G.A.A..A.A.
......AAA..G.E
