SA.A.A.AA..A..GAA....
.....G...G..A...G.G..
.AAA.AAAAA.AAG.A..A..
..G..G.A.....A.GA.AG.
..A.......AAAG.A.AA..
...A.AAAA..........G.
...AA...A..A.G..AA...
A.....A..AAAA.GAGG...
...G.GA.AG.A..A..A..G
..A....A..GG..AGA..G.
..A.G.G..AAAGA.G.A...
......AA.GAAAAA......
.A.A...GA.AA..AA..A.A
A......AAG...AA.A..A.
A.AAAG.A..A.....A...A
A..AG........A.A....A
..AAA....G.....A.AAA.
.....AAAAA...AA......
.A..A.AA....G.......G
...G..AAA...AA.AG....
..GA.A..............E
