SAAA..AAA.G.G.A.A...
..GGA.A.A.A......AA.
.....AG.AG.AAA..A...
.............GG....G
.A...A.A..AA.A..A..A
...AA.G.A....GA.A..A
A..GAAA.AAA....AAAA.
....A.A.A.A.A.......
..GAA.G.G...GGA.GG.A
..AAA.A.A...A...A.AA
........A....AAAA...
A...A.AG.....A.AA...
.GAAA..A..A.....AAA.
...A..AAAA.....AAA..
AA......G.AA....A..A
A.AAG.....AG...A..G.
.AA.AA....A.AAGA..G.
.A.AA...A.....A.AA..
AAAAG..A...A.A......
...G.A.G..AAA.A.A..E
