S.AA.GA.G
..A..AA..
.A...A...
G.AA.A.A.
.A....AA.
G.A...G..
.A..A..AA
..AAA.A..
........E
